x______x
_x____x_
__x__x__
___xx___
________
________
