_____x__
_____x__
_____x__
____xx__
________
________

MOV 1 M
NOP
..
